The Twist::Chubby Checker
Smooth::Santana Featuring Rob Thomas
Mack The Knife::Bobby Darin
How Do I Live::LeAnn Rimes
Party Rock Anthem::LMFAO Featuring Lauren Bennett & GoonRock
I Gotta Feeling::The Black Eyed Peas
Macarena (Bayside Boys Mix)::Los Del Rio
Physical::Olivia Newton-John
You Light Up My Life::Debby Boone
Hey Jude::The Beatles
We Belong Together::Mariah Carey
Uptown Funk!::Mark Ronson Featuring Bruno Mars
Un-Break My Heart::Toni Braxton
Yeah!::Usher Featuring Lil Jon & Ludacris
Bette Davis Eyes::Kim Carnes
Endless Love::Diana Ross & Lionel Richie
Tonight's The Night (Gonna Be Alright)::Rod Stewart
Foolish Games/You Were Meant For Me::Jewel
(Everything I Do) I Do It For You::Bryan Adams
I'Ll Make Love To You::Boyz II Men
The Theme From "A Summer Place"::Percy Faith And His Orchestra
Le Freak::Chic
How Deep Is Your Love::Bee Gees
Eye Of The Tiger::Survivor
We Found Love::Rihanna Featuring Calvin Harris
Low::Flo Rida Featuring T-Pain
I Just Want To Be Your Everything::Andy Gibb
Too Close::Next
Every Breath You Take::The Police
Somebody That I Used To Know::Gotye Featuring Kimbra
Flashdance...What A Feeling::Irene Cara
Rolling In The Deep::Adele
Tossin' And Turnin'::Bobby Lewis
The Battle Of New Orleans::Johnny Horton
One Sweet Day::Mariah Carey & Boyz II Men
Truly Madly Deeply::Savage Garden
Silly Love Songs::Wings
Let's Get It On::Marvin Gaye
Night Fever::Bee Gees
Another One Bites The Dust::Queen
Say Say Say::Paul McCartney And Michael Jackson
How You Remind Me::Nickelback
Tie A Yellow Ribbon Round The Ole Oak Tree::Dawn Featuring Tony Orlando
It's All In The Game::Four Tops
I Want To Hold Your Hand::The Beatles
Shadow Dancing::Andy Gibb
Call Me Maybe::Carly Rae Jepsen
Blurred Lines::Robin Thicke Featuring T.I. + Pharrell
Candle In The Wind 1997/Something About The Way You Look Tonight::Elton John
No One::Alicia Keys
I Will Always Love You::Whitney Houston
End Of The Road::Boyz II Men
Boom Boom Pow::The Black Eyed Peas
Call Me::Blondie
Let Me Love You::Mario
Stayin' Alive::Bee Gees
Lady::Kenny Rogers
Tik Tok::Ke$ha
I'm A Believer::The Monkees
Gold Digger::Kanye West Featuring Jamie Foxx
Apologize::Timbaland Featuring OneRepublic
The Sign::Ace Of Base
Centerfold::The J. Geils Band
(Just Like) Starting Over::John Lennon
Royals::Lorde
The Boy Is Mine::Brandy & Monica
Because I Love You (The Postman Song)::Stevie B
I Love Rock 'N Roll::Joan Jett & the Blackhearts
All About That Bass::Meghan Trainor
Aquarius/Let The Sunshine In::The 5th Dimension
Whoomp! (There It Is)::Tag Team
Moves Like Jagger::Maroon 5 Featuring Christina Aguilera
Ebony And Ivory::Paul McCartney And Stevie Wonder
Rush Rush::Paula Abdul
That's What Friends Are For::Dionne & Friends
Happy::Pharrell Williams
Upside Down::Diana Ross
Sugar, Sugar::The Archies
Just The Way You Are::Bruno Mars
Dilemma::Nelly Featuring Kelly Rowland
I Heard It Through The Grapevine::Marvin Gaye
You're Still The One::Shania Twain
Billie Jean::Michael Jackson
Hot Stuff::Donna Summer
Gangsta's Paradise::Coolio Featuring L.V.
Abracadabra::The Steve Miller Band
You're So Vain::Carly Simon
Play That Funky Music::Wild Cherry
Say You, Say Me::Lionel Richie
My Sharona::The Knack
All Night Long (All Night)::Lionel Richie
Nothing Compares 2 U::Sinead O'Connor
I Swear::All-4-One
Family Affair::Mary J. Blige
Waiting For A Girl Like You::Foreigner
Are You Lonesome To-Night?::Elvis Presley With The Jordanaires
Killing Me Softly With His Song::Roberta Flack
Hurts So Good::John Cougar
I'Ll Be Missing You::Puff Daddy & Faith Evans Featuring 112
Dark Horse::Katy Perry Featuring Juicy J
